####################
#                  #
#   #########      #
#                  #
####################
