####################
#..................#
#..####........####
#.............######
#..................#
####################
