####################
#..................#
#..####........#####
#..................#
####################
